NO ntext.xpm
SO stext.xpm
WE wtext.xpm
EA etext.xpm
F 100,0,0
C 200,255,255




   11111
   1E001
   11111
